3 15
WWWWWWWW
W   W  W
W   W  W
W 4PWG W
W   S  W
W 3  G W
WWWWWWWW
