100 100
WWWWWWWW
W W W  W
WPW  W W
W   G  W
W    1 W
W      W
WW     W
WWWWWWWW
